
地名的形容词和魔音形式列表
维基百科，自由的百科全书
跳转到导航跳转到搜索
以下是部分的地名的形容词形式名单在英语 和他们demonymic等价物，这表示人或这些地方的居民。

注意：魔音以复数形式给出。单数形式仅删除最后的's'，或者在-ese结尾的情况下，与复数形式相同。结尾的-men具有女性等效的-women（例如，爱尔兰人和苏格兰妇女）。在法国的终端-ois  AIS作为单数和复数两者阳刚 ; 加入的'e'（-oise  AISE ）使得它们奇异女性化; 'es'（- oises  aises）使它们具有多个女性味。在西班牙终止符“ -o”通常表示男性，通常通过将“ -o”替换为“ -a”而变为女性。复数形式通常分别是“ -os”和“ -as”。

以-ish结尾的形容词可以用作集体音名（例如英语，康沃尔语）。那些以-ch  -tch 结尾的单词（例如，法语，荷兰语）也可以，只要它们带有“ ch”音（例如，形容词捷克语不合格）。

如果形容词是链接，则链接是指向相同名称的语言或方言。（参考：民族语言，世界语言）

许多地名形容词和许多韵母还指代其他各种事物，有时带有或有时没有一个或多个附加词。（有时，使用一个或多个附加词是可选的。）值得注意的例子是奶酪，猫品种，狗品种和马品种。（请参阅来自地名的单词列表。）


内容
1	行星
2	大洲
3	次大陆地区
4个	国家和地区
5个	州，省，地区和地区
5.1	澳大利亚各州和领地
5.2	加拿大各省和地区
5.3	德国的联邦州和其他地区
5.4	印度各州和领地
5.5	孟加拉国师
5.6	马来西亚各州和领地
5.7	墨西哥州
5.8	新西兰地区
5.9	菲律宾省
5.10	美国各州
5.11	古希腊罗马地区
5.12	其他前国家和地区
5.13	虚构区域
6个	城市
7	另请参见
8	参考
9	外部链接
行星
主条目：天体形容词和名词的清单
大洲
在条目斜体是大陆地区。

名称	形容词	地名
非洲欧亚大陆	非洲欧亚大陆	非洲欧亚人
非洲	非洲人	非洲人
欧亚大陆	欧亚的	欧亚人
亚洲	亚洲人	亚洲人
中东	中东人	中东人
欧洲	欧洲人	欧洲人
美洲	美国a	美国人一
北美	北美洲	北美人
加勒比海	加勒比海	加勒比海
西印度群岛	西印度	西印度人
中美洲	中美洲	中美洲人
北美洲	北美洲	北美人
南美洲	南美洲的	南美人
南极洲	南极	南极人
大洋洲	Oceanian	Oceanians
Australasia	Australasian	Australasians
Australiab	Australianb	Australiansb
Zealandia	Zealandian	Zealandians
Pacific Islands	Pacific Islands	Pacific Islanders
aUsually used to identify specifically the United States of America or its people.
bUsually used to identify specifically the Commonwealth of Australia or its people.
Subcontinental regions
Main article Adjectivals and demonyms for subcontinental regions
Countries and nations
Main article List of adjectival and demonymic forms for countries and nations
States, Provinces, Regions and Territories
Australian states and territories
Stateterritory	Adjective	Demonym
 	colloquial
Australian Capital Territory	Canberran	Canberrans	Inlanders, Round Abouters, Canberries, Pollies
New South Wales	New South Welsh	New South Welshmen	Waratahs, Cockroaches, Blues
Northern Territory	Northern Territory	Territorians	Top Enders, Ex-pats
Queensland	Queensland	Queenslanders	Banana Benders, Cane Toads, Maroons
South Australia	South Australian	South Australians	Crow Eaters
Tasmania	Tasmanian	Tasmanians	Apple Eaters, Taswegians, Tazzies
Victoria	Victorian	Victorians	Vics, Mexicans
Western Australia	Western Australian	Western Australians	Sandgropers, Westralians
Canadian provinces and territories
Province Or Territory	Adjective	Demonym
colloquial
Alberta (Province)	Albertan	Albertans
British Columbia (Province)	British Columbian  (B.C.)	British Columbians	B.C.ers
Manitoba (Province)	Manitoban	Manitobans	Tobans
New Brunswick (Province)	New Brunswick	New Brunswickers
Newfoundland and Labrador (Province)	Newfoundland and Labrador	Newfoundlanders, Labradorians	Newfies
Northwest Territories (Territory)	Northwest Territorian   (N.W.T.)	Northwest Territorians	N.W.T.ers
Nunavut (Territory)	Nunavut	Nunavummiut (sing. Nunavummiuq)
Nova Scotia (Province)	Nova Scotian	Nova Scotians	Bluenosers
Ontario (Province)	Ontario	Ontarians
Prince Edward Island (Province)	Prince Edward Island, P.E.I., Island	Islanders
Quebec (Province)	Quebec
French Québécois (masc.), Québécoise (fem.)	Quebeckers, Quebecers
French Québécois	French Habitants
Saskatchewan (Province)	Saskatchewan	Saskatchewanians	Flat-Landers
Yukon (Territory)	Yukon	Yukoners	Sourdoughs
Federated states and other territories of Germany
Stateterritory	Adjective	Demonym
 	colloquial
Baden-Württemberg (federated state)			 
Bavaria (federated state)	Bavarian	Bavarians	German Bazis
Berlin (federated state)		Berliners	
Brandenburg (federated state)	Brandenburgish	Brandenburgers	
Franconia	Franconian	Franconians	
Free Hanseatic City of Bremen	Bremeen	Bremen  Brewomen	
Free and Hanseatic City of Hamburg	Hamburgish	Hamburgians	
Hannover (ancient German state)	Hanoverian	Hanoverians	
Hesse (federated state)	Hessian	Hessians	
Lower Saxony (federated state)	Lower Saxon	Lower Saxons	
Mecklenburg-Western Pomerania (federated state)			
North Rhine-Westphalia (federated state)	North Rhine - Westphalian	North Rhine - Westphalians	
Pomerania (ancient German territory)	Pomeranian	Pomeranians	
Prussia (ancient German state)	Prussian	Prussians	Bavarian Saupreiss'n
Rhineland (area)	Rhenish	Rhinelanders	
Rhineland-Palatinate (federated state)			
Saarland (federated state)		Saarlanders	
Saxony (federated state)	Saxon	Saxons	
Saxony-Anhalt (federated state)			
Silesia (ancient German territory)	Silesian	Silesians	
Schleswig-Holstein (federated state)			
Swabia (South German area and ancient territory)	Swabian	Swabians	
Thuringia (federated state)	Thuringian	Thuringians	
Indian states and territories
State or territory	Adjective	Demonym
colloquial
Andaman and Nicobar Islands	[1] Andamanese[1]
Nicobarese[1]	Andamanese
Nicobarese
Andhra Pradesh	Andhraite	Andhraites	Teluguvaaru
Arunachal Pradesh	Arunachali	Arunachalis
Assam	Assamese[1]	Assamese
Bihar	Bihari[1]	Biharis
Chandigarh	Chandigarhi	Chandigarhis
Chhattisgarh	Chhattisgarhi	Chhattisgarhis
Dadra and Nagar Haveli	Dadran
Nagar Havelian	Dadrans
Nagar Havelians
Daman and Diu	Damanese
Diuese	Damanese
Diuese
Delhi	Delhiite, Delhian	Delhiites, Delhians
Goa	Goan,[1] Goenkar	Goans, Goenkars
Gujarat	Gujarati[1]	Gujaratis
Haryana	Haryanvi	Haryanvis	_
Himachal Pradesh	Himachali	Himachalis
Jammu and Kashmir	Jammu
Kashmiri[1]	Jammuite
Kashimiris	_
Jharkhand	Jharkhandi	Jharkhandis
Karnataka	Karnatakan, Canarese[1] [1]	Karnatakans, Canarese, Kannadiga	Carnatic
Kerala	Keralite	Keralites	Malayalis
Lakshadweep (Laccadives)	Laccadivian	Laccadivians	
Madhya Pradesh	Madhya Pradeshi	Madhya Pradeshis
Maharashtra	Maharashtrian[1]	Maharashtrians	Marathi
Manipur	Manipuri[1]	Manipuris
Meghalaya	Meghalayan	Meghalayans
Mizoram	Mizo[1]	Mizos
Nagaland	Naga,[1] Nagalandese	Nagas
Odisha	Odia[1] (Odia) [of the people]
Odishan (Orissan) [of the state]
Odissi (Orissi)[1]	Odias (Odias)
Odishans (Orissans)	_
Puducherry (formerly Pondicherry)	Pondicherrian	Pondicherrians	_
Punjab	Punjabi[1]	Punjabis
Rajasthan	Rajasthani[1]	Rajasthanis
Sikkim	Sikkimese[1]	Sikkimese
Tamil Nadu	Tamil,[1] Tamilian	Tamils, Tamilians
Telangana	Telanganite	Telanganites
Tripura	Tripuri, Tripuran	Tripuris, Tripurans
Uttar Pradesh	Uttar Pradeshi, Hindi	Uttar Pradeshis
Uttarakhand	Uttarakhandi	Uttarakhandis
West Bengal	(West) Bengali,[1] (West) Bengalese,[1] Bangla[1]	(West) Bengalis, (West) Bengalese, Banglas
Bangladeshi divisions
Division	Adjective	Demonym
 	colloquial
Barisal Division	Barisali	Barisali (Borishali)	Barisailla (Borishailla)
Chittagong Division	Chittagonian	Chãtgaiya (Satgaiya)	Chittagainga (Sitainga)
Dhaka Division	Dhakai	Dhakaiya	Dhakaiya
Khulna Division	Khulnaiya	Khulnaiya	Khulnaiya
Mymensingh Division	Mymensinghiya	Mymensinghi	Mymensinghiya
Rajshahi Division	Rajshahiya	Rajshahiya (Rajshahiyo)	Rajshahiya
Rangpur Division	Rangpuri	Rangpuri (Rongpuri)	Rangpuri
Sylhet Division	Sylheti	Sylheti (Sileti)	Siloti
Malaysian states and territories
State  Territory	Adjective	Demonym
colloquial
Johor	Johorean	Johoreans	Southerners
Kedah	Kedahan	Kedahans
Kelantan	Kelantanese	Kelantanese	East Coasters
Kuala Lumpur	Kuala Lumpurian	Kuala Lumpurians	Federal Territorians, KL-ites
Labuan	Labuanese	Labuanese	Federal Territorians
Malacca	Malaccan	Malaccans
Negeri Sembilan	Negeri Sembilanese	Negeri Sembilanese	Negrians
Pahang	Pahangite	Pahangites
Penang	Penangite	Penangites	Penang Islanders
Perak	Perakian	Perakians
Perlis	Perlisian	Perlisians
Putrajaya	Putrajayan	Putrajayans	Federal Territorians
Sabah	Sabahan	Sabahans	Borneoans
Sarawak	Sarawakian	Sarawakians	Borneoans
Selangor	Selangorean	Selangoreans
Terengganu	Terengganuan	Terengganuans	East Coasters
Peninsular (West) Malaysia	Peninsular, West Malaysian	Peninsularians, West Malaysians	Malayans
East Malaysia	East Malaysian	East Malaysians	Borneoans
States of Mexico
Main article States of Mexico
Federal entity	Adjective	Demonym
colloquial
Aguascalientes	Hydrocalid	Hidrocálido-a	
Baja California	Lower Californian	Bajacaliforniano-a	
Baja California Sur	South Lower Californian	Sudcaliforniano-a	
Campeche	Campechan	Campechano-a	
Chiapas	Chiapan	Chiapaneco-a	
Chihuahua	Chihuahuan	Chihuahuense	
Coahuila de Zaragoza	Coahuilan	Coahuilense	
Colima	Colimean	Colimense	
Durango	Durangolese	Duranguense	
Guanajuato	Guanajuatean	Guanajuatense	
Guerrero	Guerreran	Guerrerense	
Hidalgo	Hidalgolese	Hidalguense	
Jalisco	Jaliscan	Jalisciense	Jalisquillo Tapatio Tapatia
México (state)	Mexican	Mexiquense	
Ciudad de México (Mexico City)		Defeño-a	Chilango
Michoacán de Ocampo	Michoacanese	Michoacano-a	
Morelos	Morelese	Morelense	
Nayarit	Nayarita	Nayarita	
Nuevo León	New-leonese	NeoleonésNeoleonense	
Oaxaca	Oaxacan	Oaxaqueño-a	Oaxaco
Puebla	PueblanPoblano	Poblano-a	
Querétaro de Arteaga	Queretan	Queretano-a	
Quintana Roo	Quintanaroan	Quintanarroense	
San Luis Potosí	Potosinian	Potosino-a	
Sinaloa	Sinaloan	Sinaloense	
Sonora	Sonoran	Sonorense	
Tabasco	Tabascan	Tabasqueño-a	
Tamaulipas	Tamaulipan	Tamaulipeco-a	
Tlaxcala	Tlaxcaltheque	Tlaxcalteco -a	
Veracruz de Ignacio de la Llave	Veracruzan	Veracruzano-a	
Yucatán	Yucatheque	Yucateco-a	
Zacatecas	Zacatecan	Zacatecano-a	
Capitalino is often used to refer to people from Mexico City; however, capitalino can be used to refer to people from any state capital. Defeño and Chilango are listed by the Royal Spanish Academy
New Zealand regions
RegionIsland	Adjective	Demonym
colloquial
Auckland Region	Auckland	Aucklanders	Jafas
Bay of Plenty Region	Bay of Plenty	Bay of Plentiers	BOPians
Canterbury region	Canterbury	Cantabrians	Cantabs
Gisborne Region	East Coast, Gisborne	East Coasters, Gisbornians
Hawke's Bay Region	Hawke's Bay	Hawke's Bayers
Manawatu-Wanganui Region	Manawatu, Wanganui	Manawatuans, Wanganuians
Marlborough Region	Marlborough	Marlburians
Nelson Region	Nelsonian	Nelsonians
Northland Region	Northland	Northlanders
Otago region	Otago	Otagoites
Southland region	Southland	Southlanders
Taranaki Region	Taranaki	Taranakians	'Nakians
Tasman Region	Tasman	Tasmanites
Waikato region	Waikato	Waikatoans	Mooloos
Wellington Region	Wellington, Wellingtonian	Wellingtonians
West Coast region	West Coast	West Coasters	Coasters
North Island	North Island	North Islanders
South Island	South Island  Mainland	South Islanders	Mainlanders
Stewart Island	Stewart Island, Rakiuran	Stewart Islanders
Chatham Islands	Chatham	Chatham Islanders
Philippine provinces
Main article List of demonyms for Philippine provinces
U.S. states
Main article List of demonyms for U.S. states
Regions in Greco-Roman antiquity
Regions tracing their origins (or otherwise referenced) in Greco-Roman antiquity [in cases where ancient regions are extant, this table is limited to cases where the present-day regional names retain their originalancient form].

(References Herodotus' Histories; Thucydides' Peloponnesian War; Pausanias' Description of Greece; Lemprière's Bibliotheca Classica; Leverett's 1838 edition of the Lexicon of the Latin Language; Freeman's The History of Sicily...; et al.)

Name	Adjective	Demonym
colloquial
Acarnania	Acarnanian	Acarnanians
Achaea	Achaean	Achaeans
Aegina	Aeginetan	Aeginetans
Aethaea	Aethaean	Aethaeans
Aetolia	Aetolian	Aetolians
Andalusia	Andalusian	Andalusians
Apulia	Apulian	Apulians
Aquitania	Aquitanian	Aquitanians
Arcadia	Arcadian	Arcadians
Argos	Argive	Argives
Arretium	Arretine	Arretines
Athens	Athenian	Athenians
Bactria, Bactriana	Bactrian	Bactrians
Bavaria	Bavarian	Bavarians
Boeotia	Boeotian, Beotian	Boeotians, Beotians
Boiohaemum	Boius	Boii
Bosporus, Bosphorus	Bosporan, Bosphoran	Bosporans, Bosphorans
Bruttium	(Bruttus ), Bruttian	Brutti, Bruttians
Byzantium	Byzantine	Byzantines
Calabria	Calabrian	Calabrians
Campania	Campanian	Campanians
Cantabria	Cantabrian	Cantabrians
Caria	Carian	Carians
Carthage	Carthaginian	Carthaginians
Carystus	Carystian	Carystians
Catalonia	Catalan, Catalonian	Catalans, Catalonians
Cephalonia	Cephalonian	Cephalonians
Chalcis	Chalcidian	Chalcidians
Chios	Chiot	Chiots
Colchis	Colchian	Colchians
Colossae	Colossian	Colossians
Consentia	Consentian	Consentians
Corcyra	Corcyrean	Corcyreans
Corsica	Corsican	Corsicans
Crete	Cretan	Cretans
Croton	Crotonian	Crotonians
Cyclades	Cycladian	Cycladians
Cyprus	Cypriot, Cypriote	Cypriots, Cypriotes
Cyrenaica	Cyrenaic	Cyrenaics
Cyrene	Cyrenian	Cyrenians
Dacia	Dacian	Dacians
Dalmatia	Dalmatian	Dalmatians
Delos	Delian	Delians
Dodecanese	Dodecanesian	Dodecanesians
Edonia	Edonian	Edonians
Egesta	Egestan	Egestans
Eleusina or Eleusis	Eleusian, Eleusinian	Eleusians, Eleusinians
Elis or Eleia	Elian	Elians
Ephesus	Ephesian	Ephesians
Epidamnus or Epidamnos	Epidamnian	Epidamnians
Epidaurus	Epidaurian	Epidaurians
Epirus	Epirote	Epirotes
Eretria	Eretrian	Eretrians
Etruria	Etrurian, Etruscan	Etruscans
Euboea	Euboean	Euboeans
Galatia	Galatian	Galatians
Gallaecia	Gallaecus	Gallaeci
Gallia or Gaul	Gaulish	Gauls
Germania	Germanic, Germanus	Germanic, Germani
Iberia	Iberian	Iberians
Illyria	Illyrian	Illyrians
Ionia	Ionian	Ionians
Kalymnos	Kalymnian	Kalymnians
Kaulonia	Kaulonian	Kaulonians
Knossos	Knossian	Knossians
Lakedaimonia or Lakedaemonia	Lakedaimonian or Lakedaemonian	Lakedaimonians or Lakedaemonians
Larissa	Larissan	Larissans
Latium	Latin	Latins
Leontini, Leontium	Leontinian	Leontinians
Lesbos	Lesbian	Lesbians
Locris	Locrian	Locrians
Lucania	Lucanian	Lucanians
Lydia	Lydian	Lydians
Macedonia	Macedonian	Macedonians
Maeonia	Maeonian	Maeonians
Mantineia	Mantinean	Mantineans
Marathon	Marathonian	Marathonians
Media	Median	Medes, Medians
Megara	Megarian	Megarians
Melite	Melitian	Melitians
Melos	Melian	Melians
Mesopotamia	Mesopotamian	Mesopotamians
Messenia	Messenian	Messenians
Miletus	Milesian	Milesians
Mithymna or Methymna	Methymnian	Methymnians
Moravia	Moravian	Moravians
Mycenae	Mycenaean	Mycenaeans
Mytilene	Mytilenean	Mytileneans
Naupactus or Nafpaktos	Naupactian	Naupactians
Naxos	Naxian	Naxians
Nisyros	Nisyrian	Nisyrians
Oea	Oean	Oeans
Olympia	Olympian	Olympians
Oiniades, Oiniadai	Oiniadan	Oiniadans
Orkney Islands	Orcadian	Orcadians
Paeonia or Paionia	Paeonian	Paeonians
Pamphylia	Pamphylian	Pamphylians
Paros	Parian	Parians
Patmos	Patmian	Patmians
Peloponnese	Peloponnesian	Peloponnesians
Pergamum	Pergamian	Pergamians
Persia	Persian	Persians
Philippi	Philippian	Philippians
Phlius	Phliasian	Phliasians
Phocis	Phocian	Phocians
Phoenicia	Phoenician	Phoenicians
Phrygia	Phrygian	Phrygians
Pisidia	Pisidian	Pisidians
Pontus	Pontian	Pontians
Pylos	Pylosian	Pylosians
Rhegion	Rhegian, Rhegine	Rhegians, Rhegines
Rhodes	Rhodian	Rhodians
Rhithymna, Rhithymnia, Rithymna	Rhithymnian	Rhithymnians
Rome	Roman	Romans
Sabinium	Sabine	Sabines
Salamis	Salaminian	Salaminians
Samnium	Samnite	Samnites
Samos	Samian	Samians
Sardinia	Sardinian, Sardi	Sardinians, Sardi
Sardis	Sardianus, Sardian	Sardiani, Sardians
Sarmatia	Sarmatian, Sarmata, or Sauromata	Sarmatians, Sarmatae, or Sauromatae
Scythia	Scytha, Scythian	Scythae, Scythians
Serrae, Serrhae	Serrean	Serreans
Serica	Sere	Seres
Sicily	Sicilian	Sicilians
Sicyon	Sicyonian	Sicyonian
Sidon, or Saïda	Sidonian	Sidonians
Silesia	Silesian	Silesians
Skopelos	Skopelitan	Skopelitans
Sparta	Spartan	Spartans
Suebia	Suebius	Suebi
Symi	Symian	Symians
Syracuse	Syracusan	Syracusans
Taras, Tarentum	Tarentine, Tarentumian	Tarentines, Tarentumians
Tegea	Tegean	Tegeans
Tenedos	Tenedian	Tenedians
Tenedos	Tenedian	Tenedians
Thasos	Thasian	Thasians
Thebes	Theban	Thebans
Thespis	Thespian	Thespians
Thessaly	Thessalian	Thessalians
Thrace	Thracian	Thracians
Thria	Thriasian	Thriasians
Thuria	Thuriat	Thuriats
Thurii	Thurian	Thurians
Thynia	Thynian	Thynians
Trichonos	Trichonian	Trichonians
Troezen	Troezenian	Troezenians
Troy	Trojan	Trojans
Umbria	Umbrian	Umbrians
Xanthi	Xanthian	Xanthians
Zakynthos	Zakynthian	Zakynthians
Other former nations and regions
Main article List of adjectivals and demonyms for former regions
Ancient civilizations, former colonies, renamed countries and regions, annexations, secessions, etc. (other than Greco-Roman, which see above).

Fictional regions
Name	Adjective	Demonym
Atlantis	Atlantean, Atlantine	Atlanteans, Atlantans
Aloria	Alorn	Alorns
Andor	Andorian	Andorians
Attilan		Inhumans
Blefuscu	Blefuscudian	Blefuscudians
Black Marsh	Argonian	Argonians, Saxhleel
Borduria	Bordurian	Bordurians
Brobdingnag	Brobdingnagian	Brobdingnagians
Laputa	Laputian	Laputans
Lilliput	Lilliputian	Lilliputians
Cardassia Prime	Cardassian	Cardassians
Cyrodiil	Cyrodilic	Cyrodil, Cyrods, Imperials
Bajor	Bajoran	Bajorans, Bajora
Elsweyr	Khajiiti	Khajiit
Ferenginar	Ferengi	Ferengi
Gallifrey	Gallifreyan	Gallifreyans
Genosha	Genoshan	Genoshans
Hammerfell	Redguard	Redguards
High Rock	Breton	Bretons
Islandia	Islandian	Islandians
Latveria	Latverian	Latverians
Luggnagg		Struldbrugs
Morrowind	Velothi, Dunmeri	The Dunmer, Dark Elves
Narnia	Narnian	Narnians
Daedric Planes of Oblivion	Daedric	Daedroth (sing), Daedra (pl)
Orsinium	Orcish	The Orsimer, Orcs
Oz	Ozian	Ozite[2]
Qo'noS	Klingon	Klingons
Remus	Reman	Remans
Rohan	Rohirric	Rohirrim
Romulus	Romulan	Romulans
Skaro	Skaroene, Skarosian	Skarosians
Skyrim	Nordic, Norse	Nords
Summerset Isles	Altmeri	The Altmer, High Elves
Sontar	Sontaran	Sontarans
Syldavia	Syldavian	Syldavians
Utopia	Utopian	Utopians
Wakanda	Wakandan	Wakandans
Valenwood	Bosmeri	The Bosmer, Wood Elves
Vulcan	Vulcan, Vulcanian	Vulcans
Cities
Main article Adjectivals and demonyms for cities
See also
icon	Geography portal
Demonym
List of adjectival and demonymic forms of place names
List of adjectivals and demonyms for astronomical bodies
List of adjectivals and demonyms for continental regions
List of adjectivals and demonyms for subcontinental regions
List of adjectival and demonymic forms for countries and nations
List of adjectivals and demonyms for Australia
List of adjectivals and demonyms for Canada
List of adjectivals and demonyms for India
List of adjectivals and demonyms for Malaysia
List of adjectivals and demonyms for Mexico
List of adjectivals and demonyms for New Zealand
List of adjectivals and demonyms for the Philippines
List of adjectivals and demonyms for the United States
List of adjectivals and demonyms for cities
List of adjectivals and demonyms for former regions
List of adjectivals and demonyms for Greco-Roman antiquity
List of adjectivals and demonyms for fictional regions
References
 Oxford English Dictionary. Oxford University Press. 2nd ed. 1989.
Baum，L.Frank（1908）。桃乐丝和绿野仙踪。美国：赖利和布里顿。p。272。
外部链接
	在免费词典Wiktionary中查找反义词  或gentilic。
世界魔音字母顺序列表
世界恶魔
分类：地名列表音标清单地名词源
导航菜单
未登录谈论会费创建帐号登录文章谈论读编辑查看历史搜索
Search Wikipedia
主页
内容
独具特色的内容
现在发生的事
随机文章
捐赠给维基百科
维基百科商店
相互作用
救命
关于维基百科
社区门户
近期变动
联系页面
工具类
这里有什么链接
相关变更
上传文件
特殊页面
永久链接
页面信息
维基数据项
引用此页
打印导出
创建一本书
下载为PDF
可打印的版本

语言能力
加泰罗尼亚语
西班牙文
法兰西
意大利语
荷兰
葡萄牙语
Русский
另外5个
编辑连结
本页面最后编辑于2019年9月25日 （UTC）。
文本可在知识共享署名-相同方式许可下获得；其他条款可能适用。使用本网站，您同意使用条款和隐私政策。Wikipedia®是非营利组织Wikimedia Foundation，Inc.的注册商标。
隐私政策关于维基百科免责声明联系维基百科开发者Cookie声明流动检视维基媒体基金会由MediaWiki提供支持
